AWS control tower: set blueprints guardrail for new AWS accounts.
Service control policy: manage(not grant) permissions.
Amazon elastic transcoder: convert media files.
Amazon worksapce: setup Windows or Linux desktop. Avalilable globally.
AWS cloudTrail: monitor unusual access & activity(management events) of AWS account.
AWS x-ray: helps debugging.
codeStar: for code development workflow and serverless app. codePipeline uses cloudWatch logs. 
AWS beanstalk: easily deploy. has at least one instance. does not publish metrics to CloudWatch. No additional charge.
Amazon Kinesis data streams: stream data.
AWS forecast service: forecast web traffic.
Amazon AppStream: internet(browser) app.
CloutTrail, s3 Glacier, Storage gateway: already encrypted.
AWS partner solutions(formerly quick starts): set reference point for deployment.
Security group: control incoming/outgoing traffic at instance level. ACL is at subnet level.
Architectural Tool: answering questions, to find best practice.
Architecture center: find best solutions.
AWS wavelength: setup low latency gaming/mobile app.  
AWS outpost: low latency between on-premise an AWS.
AWS IoT core: Let you connect IoT device.
AWS abuse team: report suspacious actions.
AWS OpsHub: manage AWS Snowball using UI.
AWS config: configure resources.  It has the history data of resources. Cloudwatch is for monitoring.
EC2 is Customer's responsibility, not AWS.
Backup&Restore, PilotLight, WarmStandby, MultiSiteActive: Recovery time( hours, 10min, minutes, instant)
AWS Aurora: SQL base database.
AWS quicksight: dashboard.
AWS Athena: analyze s3 using SQL.
AWS Neptune: NoSQL based database using graph.
AWS quantum Ledger database: has history of data changes.
Amazon detective: use cloudTrail, guardDuty logs, to quickly finds security issues.
AWS codeArtifact: code repository. build tools like Maven, Gradle, npm,
AWS cloudTrail Insights: When usage is high, it can alarm users.
Guard duty: monitor malicious activities.
Transit Gateway, site-to-site gateway: connect on-premise & VPC. Direct connect is physical connection.
Security inspector: security assesment. test your security.
AWS snowcone: snow family. for edge computing.
Saving plan: Compute saveing, EC2 saving. (there is no storage saving plan)
Firewall (WAF): can be used on cloudFront, load balancer, app sync.
AWS master key: used to automatically encrypt data.
Traffic between AZ zone is encrypted.
CludEndure disaster recovery: fast reliable recovery.
Storage Gateway: For hybrid environment.
Designated Account manager & Concierge is available for Enterprise plan only.
Basic support plan provides: health chech, one-on-one billing questions.
API gateway can be used on Lambda, Kinesis data stream.  
Image builder: Automatically update AMI image. 




